########################################
#.......#...#.......#.#.......#.....#.##
#.#.###.#.#####.###.#.#.###########.#.##
#.#...#.#.#.....#.....#.#...........#.##
#.#######.#.#####.#.###.#.#####.#####.##
#...#...#.#.#...#.#...#.#.....#.......##
###.###.#.###.#.#.#####.#.#.############
#...#.....#...#.........#.#...........##
#.###.#############.#######.#######.#.##
#.#...#.......#...#.......#...#.#.#.#.##
#.#.#########.#.#.###.#######.#.#.######
#.......#.....#.#.....#.......#...#...##
#######.#.###.###.#####.###.###.#.###.##
#...#.......#.#.#.#.....#.#.#...#.#...##
###.#######.#.#.#.###.###.#.#.###.#.#.##
#.......#.#.#.......#.#...#.#...#...#.##
#.#######.#.#.#.#.#.#.#.###.#####.###.##
#.#...#...#.#.#.#.#.#.#.#.#.#.....#...##
#.#.###.#########.###.#.#.###.###.######
#...#...#...#...........#.......#...#.##
#.###.#####.#.#.#.###.#####.#####.#.#.##
#.#...#...#...#.#.#...#.......#.#.#.#.##
#.#.#####.#####.###.#.#.#####.#.###.#.##
#...#.....#.....#.#.#.#...#...#...#...##
#.###.#######.###.###.###.#######.#.####
#.......#...#...#...#.#.#.#.......#...##
#######.#.#.#.#.#.#.#.#.#.###.##########
#...#...#.#...#...#.#.......#...#.....##
#.###.###.#.#######.#######.###.###.#.##
#.........#...#...........#...#.....#.##
#######.#####.#######.###.###.#.###.####
#.......#.....#.......#...#.....#...#.##
#.#.#######.#######.###.###.###.#.###.##
#.#...#...#...#.#...#...#...#...#.#...##
#.#.#.###.#####.#####.###.###.#####.####
#.#.#.#...#.....#.....#.....#.#.......##
#.###.#.###.###.#.###########.###.###.##
#...#.......#...#...........#.....#...##
########################################
########################################
